111111111111
121110000001
101100111101
101101111001
100001000011
111111011111
100000010001
101111110101
100000000131
111111111111